1 1 1 1 1 1 1 1 1 1 1 1 1 1 1 1 1 1 1 1 1 1 1 1
1 2 2 2 2 3 2 4 2 2 2 2 2 3 2 2 2 2 2 2 5 2 2 1
1 2 0 2 2 3 2 2 4 3 2 2 2 3 2 2 3 3 3 2 4 5 2 1
1 2 2 2 2 3 4 2 2 3 2 2 4 2 2 2 3 5 2 2 2 2 2 1
1 2 2 2 4 3 2 2 2 3 2 2 2 2 2 2 3 2 5 2 2 4 2 1
1 2 4 2 4 3 2 2 2 3 5 2 2 3 2 2 3 2 2 2 2 2 2 1
1 2 2 2 2 4 2 2 2 3 2 2 2 3 2 2 3 2 2 2 2 2 2 1
1 5 2 2 2 2 2 2 2 3 2 2 2 3 2 2 2 2 2 2 2 2 2 1
1 3 3 3 3 3 3 3 3 3 3 3 3 3 3 3 3 3 3 3 3 2 2 1
1 2 2 2 2 2 2 2 2 2 2 2 3 2 2 4 4 2 2 2 2 2 4 1
1 2 4 5 2 2 2 4 2 2 2 2 3 2 2 2 4 2 2 5 2 2 2 1
1 2 5 2 2 3 2 2 2 2 2 2 2 2 2 2 2 2 2 2 2 2 2 1
1 2 2 2 2 3 2 2 5 5 2 2 2 2 2 2 2 2 2 2 4 2 2 1
1 1 1 1 1 1 1 1 1 1 1 1 1 1 1 1 1 1 1 1 1 1 1 1