1 1 1 1 1 1 1 1 1 1 1 1 1 1 1 1 1 1 1 1 1 1 1 1
1 2 2 2 2 2 2 2 2 2 2 2 2 2 2 2 2 2 2 3 5 5 5 1
1 2 2 4 4 4 2 2 2 2 2 2 2 2 2 2 2 2 2 3 5 5 5 1
1 2 2 4 5 4 2 2 2 2 2 2 2 2 2 2 2 2 2 3 5 5 5 1
1 2 2 4 4 4 2 2 2 2 2 2 2 2 2 2 2 2 2 3 2 3 3 1
1 2 2 2 2 2 2 2 2 2 2 2 2 2 2 2 2 2 2 4 0 0 0 1
1 3 3 3 3 3 3 2 2 2 3 3 3 2 2 2 3 3 3 3 3 3 3 1
1 2 2 2 2 2 2 2 2 2 2 2 2 2 2 2 2 2 2 2 2 2 2 1
1 2 2 2 2 2 2 2 2 2 2 2 2 2 2 2 2 2 2 2 2 2 2 1
1 2 2 2 2 2 2 2 2 2 2 2 2 2 2 2 2 2 2 2 2 2 2 1
1 6 2 2 2 2 2 2 2 2 2 2 2 2 2 2 2 2 2 2 2 2 2 1
1 2 2 2 2 2 2 2 2 2 4 4 4 2 2 2 2 2 2 2 2 2 2 1
1 2 2 2 2 2 2 2 2 2 4 7 4 2 2 2 2 2 2 2 2 2 2 1
1 1 1 1 1 1 1 1 1 1 1 1 1 1 1 1 1 1 1 1 1 1 1 1